11111111
100C0001
101C00
1P001001
1CC01C01
10001001
10E01001
11111111
