1111011111
1000000001
1010000001
1C00100P0C
1000000001
1000000001
C000100001
1000100001
10E0100001
1111111111
