1111111111
1000000001
10100E0001
1P00100001
1000000E01
1000000001
1000100001
1000100001
10C0100001
1111111111
