1111111111111111111111111111111110
000000000000000C00000C000000000001
10100101E00100001010010000C0010101
1010010010101010001001000000010101
1P00000000000000000000000000000001
1111111111111111111111111111111111
