1111111111111111111111111111111111
100000000000000C00000C000000000001
10100101E00100001010010000C0010101
1010010010101010001001000000010101
1P0000000000000000000000000000000C
0111111111111111111111111111111111
