11111
100C1
101C1
     
1P001
1CC01
10001
10E01
11111
